*********************************************
*                                           *
*                                           *
*                                           *
*                                           *
*                                           *
*                                           *
*                                           *
*                                           *
*                                           *
*                                           *
*                                           *
*                                           *
*     ###      ####       ####      ###     *
*    #####    ######     ######    #####    *
*    #####    ######     ######    #####    *
*                                           *
*                                           *
*                                           *
*********************************************